111111111111111111111
1000000000000000000P1
100000C0000000C0000E1
100000000000000000001
111111111111111111111
