111111111111111111111
1000000000000P0000001
10000000000000000E001
100000C00000000000001
111111111111111111111
