111111111111111111111
1000000000000P0000001
100000E00000000000001
10000000C000000000001
111111111111111111111
