1111111111111111111111111111
1000010000000000000000010C01
100P000000111110000000010001
100000000000000C000000011001
1000010000000111000000001001
1000111C00000100000001110C01
1000000000000101111111E10001
100000000000010C000000010001
1111111111111111111111111111
