1111111111111
1CEP111111111
1111111111111
